//MAP CONVERTED BY dmm2tgm.py THIS HEADER COMMENT PREVENTS RECONVERSION, DO NOT REMOVE
"ax" = (
/obj/machinery/door/poddoor{
	id = "premier_bridge";
	dir = 4
	},
/obj/machinery/power/shieldwallgen/atmos/roundstart{
	id = "brawler_aft_holo"
	},
/turf/open/floor/plating,
/area/ship/engineering/engine)
"ay" = (
/obj/structure/cable{
	icon_state = "1-8"
	},
/obj/structure/grille,
/turf/open/floor/engine,
/area/ship/engineering/engine)
"aR" = (
/obj/structure/cable{
	icon_state = "2-8"
	},
/obj/structure/grille,
/turf/open/floor/engine,
/area/ship/engineering/engine)
"cF" = (
/turf/closed/wall/r_wall/syndicate/nodiagonal,
/area/ship/engineering/engine)
"dx" = (
/obj/machinery/door/poddoor{
	id = "premier_bridge";
	dir = 4
	},
/turf/open/floor/plating,
/area/ship/engineering/engine)
"fd" = (
/obj/machinery/atmospherics/pipe/simple/supply/hidden/layer2{
	dir = 8
	},
/obj/effect/turf_decal/siding/wideplating{
	dir = 4
	},
/obj/effect/turf_decal/industrial/warning{
	dir = 4
	},
/obj/effect/decal/cleanable/glass{
	pixel_x = -9;
	dir = 8
	},
/turf/open/floor/plasteel/patterned/cargo_one,
/area/ship/engineering/engine)
"fV" = (
/obj/effect/decal/cleanable/glass{
	pixel_x = 4;
	pixel_y = 5;
	dir = 4
	},
/obj/machinery/airalarm/directional/south,
/obj/effect/turf_decal/siding/wideplating{
	dir = 10
	},
/obj/effect/turf_decal/industrial/warning{
	dir = 8
	},
/obj/structure/fluff/bus{
	dir = 4;
	can_buckle = 1
	},
/obj/effect/decal/cleanable/plasma{
	pixel_x = 8
	},
/turf/open/floor/plasteel/patterned/cargo_one,
/area/ship/engineering/engine)
"gb" = (
/obj/machinery/atmospherics/pipe/simple/scrubbers/hidden/layer4{
	dir = 10
	},
/obj/effect/turf_decal/siding/wideplating{
	dir = 8
	},
/turf/open/floor/plasteel/patterned/cargo_one,
/area/ship/engineering/engine)
"gR" = (
/obj/structure/closet/secure_closet{
	icon_state = "sec";
	name = "equipment locker";
	req_access_txt = "1"
	},
/obj/structure/window/reinforced{
	dir = 4
	},
/obj/item/clothing/suit/armor/vest/bulletproof/frontier{
	pixel_y = -4
	},
/obj/item/storage/belt/military/assault{
	pixel_y = -11
	},
/obj/item/clothing/head/helmet/bulletproof/x11/frontier{
	pixel_y = 6
	},
/obj/effect/turf_decal/industrial/warning{
	dir = 1
	},
/obj/effect/turf_decal/siding/wideplating,
/obj/item/clothing/head/helmet/bulletproof/x11/frontier{
	pixel_y = 6
	},
/obj/item/clothing/head/helmet/bulletproof/x11/frontier{
	pixel_y = 6
	},
/obj/item/clothing/head/helmet/bulletproof/x11/frontier{
	pixel_y = 6
	},
/obj/item/clothing/suit/armor/vest/bulletproof/frontier{
	pixel_y = -4
	},
/obj/item/clothing/suit/armor/vest/bulletproof/frontier{
	pixel_y = -4
	},
/obj/item/clothing/suit/armor/vest/bulletproof/frontier{
	pixel_y = -4
	},
/obj/item/storage/belt/military/assault{
	pixel_y = -11
	},
/obj/item/storage/belt/military/assault{
	pixel_y = -11
	},
/obj/item/storage/belt/military/assault{
	pixel_y = -11
	},
/obj/item/melee/knife/survival{
	pixel_x = -8
	},
/obj/item/melee/knife/survival{
	pixel_x = -4
	},
/obj/item/melee/knife/survival,
/obj/item/melee/knife/survival{
	pixel_x = 4
	},
/obj/item/melee/knife/survival{
	pixel_x = 8
	},
/obj/item/storage/backpack/duffelbag/syndie/c4{
	pixel_y = 8
	},
/turf/open/floor/plasteel/patterned/cargo_one,
/area/ship/engineering/engine)
"gV" = (
/obj/structure/cable/yellow{
	icon_state = "5-10"
	},
/obj/structure/cable/yellow{
	icon_state = "4-10"
	},
/obj/effect/decal/cleanable/dirt,
/obj/structure/cable{
	icon_state = "1-2"
	},
/obj/effect/decal/cleanable/oil/streak{
	pixel_x = 5;
	pixel_y = -2
	},
/turf/open/floor/plasteel/patterned/cargo_one,
/area/ship/engineering/engine)
"hE" = (
/obj/effect/decal/cleanable/dirt,
/obj/structure/window/reinforced{
	dir = 8
	},
/obj/effect/turf_decal/corner/opaque/blue/diagonal,
/obj/effect/turf_decal/siding/blue{
	dir = 8
	},
/obj/machinery/iv_drip,
/turf/open/floor/plasteel/white,
/area/ship/engineering/engine)
"hG" = (
/obj/structure/cable/yellow{
	icon_state = "1-8"
	},
/obj/machinery/atmospherics/pipe/simple/supply/hidden/layer2{
	dir = 8
	},
/obj/effect/decal/cleanable/oil/streak{
	pixel_x = -1;
	pixel_y = 19;
	icon_state = "streak2"
	},
/turf/open/floor/plasteel/patterned/cargo_one,
/area/ship/engineering/engine)
"hK" = (
/obj/effect/decal/cleanable/dirt,
/obj/machinery/atmospherics/pipe/simple/scrubbers/hidden/layer4{
	dir = 10
	},
/obj/machinery/cryopod{
	dir = 8
	},
/obj/structure/railing{
	dir = 2;
	layer = 4.1
	},
/obj/machinery/computer/cryopod/directional/east,
/obj/machinery/light/directional/north,
/obj/effect/decal/cleanable/plasma{
	pixel_x = 18;
	pixel_y = -5
	},
/turf/open/floor/plasteel/telecomms_floor,
/area/ship/engineering/engine)
"ic" = (
/obj/effect/decal/cleanable/dirt,
/obj/machinery/door/airlock/command{
	dir = 4
	},
/obj/machinery/atmospherics/pipe/simple/scrubbers/hidden/layer4{
	dir = 4
	},
/turf/open/floor/plasteel/patterned/cargo_one,
/area/ship/engineering/engine)
"in" = (
/obj/structure/cable/yellow{
	icon_state = "2-9"
	},
/obj/effect/decal/cleanable/dirt,
/obj/machinery/atmospherics/pipe/simple/scrubbers/hidden/layer4{
	dir = 4
	},
/turf/open/floor/plasteel/patterned/cargo_one,
/area/ship/engineering/engine)
"ko" = (
/obj/machinery/computer/helm{
	dir = 8;
	icon_state = "computer-right"
	},
/obj/structure/window/reinforced,
/obj/effect/turf_decal/siding/wideplating{
	dir = 4
	},
/obj/item/reagent_containers/food/drinks/drinkingglass/shotglass{
	pixel_x = 6;
	pixel_y = 8
	},
/obj/item/reagent_containers/food/drinks/drinkingglass/shotglass{
	pixel_x = 6;
	pixel_y = 16
	},
/obj/item/reagent_containers/food/drinks/drinkingglass/shotglass{
	pixel_x = 6;
	pixel_y = 24
	},
/obj/item/reagent_containers/food/drinks/drinkingglass/shotglass{
	pixel_x = 6;
	pixel_y = 32
	},
/obj/item/reagent_containers/food/drinks/bottle/vodka{
	pixel_x = -5
	},
/turf/open/floor/plasteel/patterned/cargo_one,
/area/ship/engineering/engine)
"kL" = (
/obj/structure/window/reinforced{
	dir = 8
	},
/obj/effect/turf_decal/corner/opaque/blue/diagonal,
/obj/effect/turf_decal/siding/blue{
	dir = 8
	},
/obj/structure/closet/crate/freezer/blood,
/obj/structure/sink/greyscale{
	pixel_y = 18
	},
/obj/item/storage/cans/sixbeer,
/turf/open/floor/plasteel/white,
/area/ship/engineering/engine)
"kR" = (
/turf/open/floor/engine/hull,
/area/ship/engineering/engine)
"lY" = (
/obj/effect/turf_decal/siding/wideplating{
	dir = 6
	},
/obj/effect/turf_decal/industrial/warning/corner{
	dir = 4
	},
/obj/machinery/autolathe/hacked,
/obj/item/stack/sheet/glass/twenty{
	pixel_x = 3
	},
/obj/item/stack/sheet/metal/twenty{
	pixel_x = 7;
	pixel_y = 4
	},
/obj/item/storage/toolbox/mechanical{
	pixel_y = 9;
	pixel_x = -5
	},
/obj/item/storage/toolbox/electrical{
	pixel_x = 4
	},
/turf/open/floor/plasteel/patterned/cargo_one,
/area/ship/engineering/engine)
"pc" = (
/obj/structure/cable/yellow{
	icon_state = "1-2"
	},
/obj/structure/cable/yellow{
	icon_state = "2-8"
	},
/obj/effect/decal/cleanable/dirt,
/obj/machinery/atmospherics/components/unary/vent_scrubber/on/layer4{
	dir = 4
	},
/turf/open/floor/plasteel/patterned/cargo_one,
/area/ship/engineering/engine)
"pD" = (
/obj/structure/cable{
	icon_state = "1-8"
	},
/obj/structure/grille,
/obj/structure/window/reinforced{
	dir = 8
	},
/turf/open/floor/engine,
/area/ship/engineering/engine)
"rB" = (
/obj/structure/bed{
	dir = 1
	},
/obj/item/reagent_containers/food/drinks/bottle/whiskey{
	pixel_y = 7;
	pixel_x = -8
	},
/obj/item/reagent_containers/food/drinks/bottle/whiskey{
	pixel_y = 10;
	pixel_x = -1
	},
/obj/effect/turf_decal/corner/opaque/blue/full,
/obj/effect/turf_decal/siding/blue{
	dir = 7
	},
/obj/structure/window/reinforced,
/obj/item/paper/crumpled{
	pixel_y = -8;
	pixel_x = -4
	},
/obj/effect/decal/cleanable/blood/gibs/down,
/turf/open/floor/plasteel/white,
/area/ship/engineering/engine)
"ss" = (
/obj/effect/decal/cleanable/dirt,
/obj/structure/cable{
	icon_state = "1-2"
	},
/turf/open/floor/plasteel/patterned/cargo_one,
/area/ship/engineering/engine)
"sM" = (
/obj/effect/turf_decal/siding/wideplating{
	dir = 1
	},
/obj/structure/curtain/cloth/grey,
/obj/structure/bed/double/maint{
	dir = 1
	},
/obj/item/bedsheet/dorms/double,
/obj/item/wallframe/extinguisher_cabinet{
	pixel_y = 17;
	pixel_x = -2
	},
/turf/open/floor/plasteel/grimy,
/area/ship/engineering/engine)
"sO" = (
/obj/machinery/atmospherics/components/unary/outlet_injector/on/layer4{
	dir = 1
	},
/turf/open/floor/engine/hull,
/area/ship/engineering/engine)
"sV" = (
/obj/structure/railing{
	dir = 1
	},
/turf/template_noop,
/area/space)
"tx" = (
/obj/structure/sign/warning/enginesafety,
/turf/closed/wall/r_wall/rust,
/area/ship/engineering/engine)
"uG" = (
/obj/structure/cable{
	icon_state = "2-8"
	},
/obj/structure/grille,
/obj/structure/window/reinforced{
	dir = 8
	},
/turf/open/floor/engine,
/area/ship/engineering/engine)
"uP" = (
/obj/machinery/atmospherics/components/unary/vent_pump/on/layer2{
	dir = 8
	},
/obj/effect/decal/cleanable/plasma{
	pixel_x = 18;
	pixel_y = -5
	},
/turf/open/floor/plasteel/patterned/cargo_one,
/area/ship/engineering/engine)
"vC" = (
/obj/machinery/power/smes/engineering,
/obj/structure/cable{
	icon_state = "0-8"
	},
/obj/effect/turf_decal/industrial/hatch/yellow,
/obj/structure/window/reinforced{
	dir = 8
	},
/obj/effect/turf_decal/siding/wideplating{
	dir = 1
	},
/obj/machinery/light/directional/north,
/turf/open/floor/plasteel/patterned/cargo_one,
/area/ship/engineering/engine)
"wn" = (
/obj/effect/decal/cleanable/dirt,
/obj/machinery/atmospherics/pipe/manifold/supply/hidden/layer2,
/obj/effect/turf_decal/siding/wideplating{
	dir = 8
	},
/turf/open/floor/plasteel/patterned/cargo_one,
/area/ship/engineering/engine)
"xq" = (
/obj/machinery/power/port_gen/pacman{
	anchored = 1
	},
/obj/structure/cable{
	icon_state = "0-1"
	},
/obj/item/stack/sheet/mineral/plasma/twenty,
/obj/item/stack/sheet/mineral/plasma/twenty,
/obj/effect/turf_decal/industrial/hatch/yellow,
/obj/structure/window/reinforced{
	dir = 8
	},
/obj/effect/turf_decal/siding/wideplating,
/obj/machinery/light/directional/south,
/turf/open/floor/plasteel/patterned/cargo_one,
/area/ship/engineering/engine)
"zO" = (
/obj/machinery/power/terminal{
	dir = 1
	},
/obj/structure/cable/yellow{
	icon_state = "0-2"
	},
/obj/effect/decal/cleanable/dirt,
/obj/machinery/suit_storage_unit/industrial{
	suit_type = /obj/item/clothing/suit/space/hardsuit/security/independent/frontier
	},
/obj/effect/turf_decal/siding/wideplating{
	dir = 1
	},
/obj/structure/window/reinforced{
	dir = 4
	},
/turf/open/floor/plasteel/patterned/cargo_one,
/area/ship/engineering/engine)
"Bd" = (
/obj/effect/turf_decal/siding/wideplating{
	dir = 8
	},
/obj/effect/turf_decal/industrial/warning{
	dir = 8
	},
/turf/open/floor/plasteel/patterned/cargo_one,
/area/ship/engineering/engine)
"BX" = (
/obj/structure/railing/corner{
	dir = 4
	},
/turf/template_noop,
/area/space)
"CH" = (
/obj/machinery/power/shuttle/engine/electric/premium{
	dir = 4
	},
/turf/open/space/basic,
/area/ship/engineering/engine)
"Ef" = (
/obj/effect/decal/cleanable/glass{
	pixel_x = 4;
	pixel_y = 5;
	dir = 4
	},
/obj/machinery/atmospherics/pipe/simple/scrubbers/hidden/layer4{
	dir = 5
	},
/obj/structure/railing{
	dir = 10;
	layer = 3.1
	},
/obj/structure/closet/secure_closet/wall/directional/south,
/obj/item/clothing/shoes/jackboots{
	pixel_y = -13;
	pixel_x = -8
	},
/obj/item/clothing/shoes/jackboots{
	pixel_y = -13;
	pixel_x = -4
	},
/obj/item/clothing/shoes/jackboots{
	pixel_y = -13
	},
/obj/item/clothing/shoes/jackboots{
	pixel_y = -13;
	pixel_x = 4
	},
/obj/item/clothing/shoes/jackboots{
	pixel_y = -13;
	pixel_x = 8
	},
/obj/item/radio{
	pixel_x = -6;
	pixel_y = 3
	},
/obj/item/radio{
	pixel_x = -6;
	pixel_y = 8
	},
/obj/item/radio{
	pixel_x = 6;
	pixel_y = 9
	},
/obj/item/radio{
	pixel_x = 6;
	pixel_y = 9
	},
/obj/item/radio{
	pixel_x = -6;
	pixel_y = 3
	},
/obj/item/flashlight{
	pixel_x = 8;
	pixel_y = -9
	},
/obj/item/flashlight{
	pixel_x = 8;
	pixel_y = -9
	},
/obj/item/flashlight{
	pixel_x = 8;
	pixel_y = -9
	},
/obj/item/flashlight{
	pixel_x = 8;
	pixel_y = -9
	},
/obj/item/flashlight{
	pixel_x = 8;
	pixel_y = -9
	},
/obj/item/clothing/under/frontiersmen{
	pixel_x = -7
	},
/obj/item/clothing/under/frontiersmen{
	pixel_x = -4
	},
/obj/item/clothing/under/frontiersmen,
/obj/item/clothing/under/frontiersmen{
	pixel_x = 4
	},
/obj/item/clothing/under/frontiersmen{
	pixel_x = 8
	},
/turf/open/floor/plasteel/telecomms_floor,
/area/ship/engineering/engine)
"Eg" = (
/obj/effect/decal/cleanable/dirt,
/obj/machinery/atmospherics/pipe/simple/scrubbers/hidden/layer4{
	dir = 4
	},
/turf/open/floor/plasteel/patterned/cargo_one,
/area/ship/engineering/engine)
"Es" = (
/obj/structure/railing/corner,
/turf/template_noop,
/area/space)
"Ey" = (
/obj/machinery/computer/crew{
	dir = 8;
	icon_state = "computer-left"
	},
/obj/structure/fluff/paper/stack{
	pixel_y = -16;
	pixel_x = -2
	},
/obj/item/reagent_containers/food/drinks/drinkingglass/shotglass{
	pixel_x = 6;
	pixel_y = 16
	},
/obj/item/reagent_containers/food/drinks/drinkingglass/shotglass{
	pixel_x = 6;
	pixel_y = 8
	},
/obj/effect/turf_decal/siding/wideplating{
	dir = 4
	},
/obj/effect/decal/cleanable/dirt,
/turf/open/floor/plasteel/patterned/cargo_one,
/area/ship/engineering/engine)
"FI" = (
/obj/effect/decal/cleanable/dirt,
/obj/effect/turf_decal/siding/wideplating,
/obj/effect/spawner/lootdrop/ration{
	pixel_x = -6;
	pixel_y = 12
	},
/obj/effect/spawner/lootdrop/ration{
	pixel_x = -6
	},
/obj/effect/spawner/lootdrop/ration{
	pixel_x = -6;
	pixel_y = 4
	},
/obj/effect/spawner/lootdrop/ration{
	pixel_x = -6;
	pixel_y = -6
	},
/obj/effect/spawner/lootdrop/ration{
	pixel_x = -6;
	pixel_y = -12
	},
/obj/structure/table,
/obj/machinery/button/door{
	dir = 8;
	id = "twinkle_rightmassdriver";
	pixel_x = 12;
	pixel_y = -5
	},
/obj/item/radio/intercom/wideband/table{
	dir = 4;
	pixel_x = 10;
	pixel_y = 8
	},
/obj/structure/fluff/paper/stack{
	dir = 5;
	layer = 2.79;
	pixel_y = 4
	},
/turf/open/floor/plasteel/patterned/cargo_one,
/area/ship/engineering/engine)
"GS" = (
/obj/machinery/power/terminal{
	dir = 1
	},
/obj/structure/cable/yellow{
	icon_state = "0-2"
	},
/obj/structure/window/reinforced{
	dir = 8
	},
/obj/machinery/suit_storage_unit/industrial{
	suit_type = /obj/item/clothing/suit/space/hardsuit/security/independent/frontier
	},
/obj/effect/turf_decal/siding/wideplating{
	dir = 1
	},
/turf/open/floor/plasteel/patterned/cargo_one,
/area/ship/engineering/engine)
"Hf" = (
/obj/structure/cable{
	icon_state = "1-2"
	},
/obj/structure/cable{
	icon_state = "1-8"
	},
/obj/structure/cable{
	icon_state = "2-4"
	},
/obj/structure/grille,
/obj/structure/window/reinforced{
	dir = 8
	},
/turf/open/floor/engine,
/area/ship/engineering/engine)
"Hm" = (
/turf/template_noop,
/area/space)
"Hx" = (
/obj/structure/fluff/bus/passable/seat/driver{
	can_buckle = 1;
	pixel_x = 5
	},
/turf/open/floor/plasteel/patterned/cargo_one,
/area/ship/engineering/engine)
"II" = (
/obj/machinery/power/smes/shuttle/precharged{
	dir = 2
	},
/obj/structure/window/reinforced,
/turf/open/floor/engine,
/area/ship/engineering/engine)
"Jh" = (
/obj/docking_port/mobile{
	dir = 4
	},
/turf/open/floor/engine/hull,
/area/ship/engineering/engine)
"Jl" = (
/obj/effect/decal/cleanable/dirt,
/obj/effect/turf_decal/siding/wideplating{
	dir = 8
	},
/obj/effect/turf_decal/industrial/warning{
	dir = 8
	},
/turf/open/floor/plasteel/patterned/cargo_one,
/area/ship/engineering/engine)
"Jv" = (
/obj/structure/cable/yellow{
	icon_state = "0-5"
	},
/obj/machinery/power/apc/auto_name/directional/south,
/obj/structure/cable{
	icon_state = "0-1"
	},
/obj/effect/turf_decal/siding/wideplating,
/obj/machinery/light_switch{
	dir = 1;
	pixel_x = 12;
	pixel_y = -16
	},
/obj/structure/fluff/bus{
	dir = 4;
	can_buckle = 1
	},
/obj/item/book/fish_catalog{
	pixel_y = 5;
	pixel_x = 6
	},
/obj/item/bikehorn/rubberducky{
	pixel_x = 7;
	pixel_y = -2
	},
/turf/open/floor/plasteel/patterned/cargo_one,
/area/ship/engineering/engine)
"KZ" = (
/obj/machinery/atmospherics/pipe/layer_manifold{
	dir = 1
	},
/obj/structure/reagent_dispensers/fueltank,
/obj/machinery/door/window/southleft,
/turf/open/floor/engine,
/area/ship/engineering/engine)
"Lr" = (
/obj/machinery/door/firedoor/window,
/obj/structure/window/reinforced/fulltile,
/obj/structure/grille,
/turf/open/floor/plating,
/area/ship/engineering/engine)
"Lz" = (
/obj/effect/turf_decal/corner/opaque/blue/diagonal,
/obj/effect/turf_decal/siding/blue{
	dir = 10
	},
/obj/machinery/door/window/westright,
/obj/structure/window/reinforced,
/turf/open/floor/plasteel/white,
/area/ship/engineering/engine)
"LT" = (
/turf/closed/wall/r_wall/rust,
/area/ship/engineering/engine)
"Mf" = (
/obj/machinery/door/airlock/command{
	dir = 4
	},
/turf/open/floor/plasteel/patterned/cargo_one,
/area/ship/engineering/engine)
"Nm" = (
/obj/machinery/power/terminal,
/obj/structure/cable/yellow{
	icon_state = "0-1"
	},
/obj/effect/decal/cleanable/dirt,
/obj/machinery/suit_storage_unit/industrial{
	suit_type = /obj/item/clothing/suit/space/hardsuit/security/independent/frontier
	},
/obj/structure/window/reinforced{
	dir = 8
	},
/obj/effect/turf_decal/siding/wideplating,
/turf/open/floor/plasteel/patterned/cargo_one,
/area/ship/engineering/engine)
"Nn" = (
/obj/machinery/power/terminal{
	dir = 1
	},
/obj/structure/cable{
	icon_state = "0-2"
	},
/obj/effect/decal/cleanable/oil/streak{
	pixel_x = -1;
	pixel_y = 19;
	icon_state = "streak2"
	},
/turf/open/floor/plasteel/patterned/cargo_one,
/area/ship/engineering/engine)
"Nr" = (
/obj/effect/decal/cleanable/dirt,
/obj/effect/turf_decal/siding/wideplating{
	dir = 9
	},
/obj/machinery/button/door{
	id = "watchdog_cargo";
	pixel_y = 25;
	pixel_x = -3
	},
/obj/machinery/button/shieldwallgen{
	id = "tortuga_holo";
	pixel_x = 8;
	pixel_y = 23
	},
/obj/effect/turf_decal/industrial/warning{
	dir = 8
	},
/obj/effect/decal/cleanable/blood,
/obj/structure/fluff/bus{
	dir = 4;
	can_buckle = 1
	},
/obj/item/lighter{
	pixel_x = -2;
	pixel_y = 9
	},
/obj/item/kitchen/spoon/plastic{
	pixel_x = 10;
	pixel_y = 10
	},
/obj/item/reagent_containers/glass/bottle{
	pixel_x = 10;
	pixel_y = 10
	},
/obj/item/reagent_containers/glass/bottle{
	pixel_x = 10;
	pixel_y = 10
	},
/obj/item/storage/pill_bottle/floorpill/full{
	pixel_x = 10;
	pixel_y = 1
	},
/turf/open/floor/plasteel/patterned/cargo_one,
/area/ship/engineering/engine)
"NH" = (
/obj/structure/window/reinforced/fulltile,
/obj/structure/grille,
/obj/machinery/door/firedoor/window,
/turf/open/floor/plating,
/area/ship/engineering/engine)
"NV" = (
/obj/effect/decal/cleanable/dirt,
/obj/effect/decal/cleanable/oil/streak,
/obj/effect/turf_decal/siding/wideplating{
	dir = 5
	},
/obj/effect/turf_decal/industrial/warning/corner,
/obj/structure/window/reinforced{
	dir = 8
	},
/obj/item/reagent_containers/glass/bucket,
/obj/structure/curtain/cloth/grey,
/obj/structure/fluff/broken_flooring{
	icon_state = "plating"
	},
/obj/effect/decal/cleanable/blood/gibs/bubblegum,
/obj/effect/decal/cleanable/glass{
	pixel_x = -9;
	dir = 8
	},
/obj/effect/decal/cleanable/plasma{
	pixel_x = 18;
	pixel_y = -5
	},
/turf/open/floor/plasteel/patterned/cargo_one,
/area/ship/engineering/engine)
"Ou" = (
/obj/effect/decal/cleanable/dirt,
/obj/structure/cable{
	icon_state = "1-2"
	},
/obj/effect/decal/cleanable/blood,
/turf/open/floor/plasteel/patterned/cargo_one,
/area/ship/engineering/engine)
"Oy" = (
/obj/effect/decal/cleanable/glass{
	pixel_x = 4;
	pixel_y = 5;
	dir = 4
	},
/obj/machinery/atmospherics/components/binary/pump,
/obj/machinery/ltsrbt,
/obj/item/blackmarket_uplink,
/obj/effect/decal/cleanable/dirt,
/turf/open/floor/engine,
/area/ship/engineering/engine)
"OG" = (
/obj/structure/cable{
	icon_state = "2-8"
	},
/obj/structure/cable{
	icon_state = "1-2"
	},
/obj/structure/cable{
	icon_state = "1-4"
	},
/obj/structure/grille,
/obj/structure/window/reinforced{
	dir = 8
	},
/turf/open/floor/engine,
/area/ship/engineering/engine)
"Pb" = (
/obj/effect/decal/cleanable/dirt,
/obj/machinery/atmospherics/pipe/simple/scrubbers/hidden/layer4{
	dir = 4
	},
/obj/effect/turf_decal/siding/wideplating{
	dir = 4
	},
/obj/effect/turf_decal/industrial/warning{
	dir = 4
	},
/obj/effect/decal/cleanable/oil{
	pixel_y = 11;
	pixel_x = 17
	},
/turf/open/floor/plasteel/patterned/cargo_one,
/area/ship/engineering/engine)
"Pf" = (
/obj/machinery/atmospherics/components/unary/vent_scrubber/on/layer4{
	dir = 8
	},
/obj/effect/decal/cleanable/dirt,
/obj/effect/turf_decal/siding/wideplating,
/turf/open/floor/plasteel/patterned/cargo_one,
/area/ship/engineering/engine)
"PE" = (
/obj/effect/decal/cleanable/glass{
	pixel_x = -9;
	dir = 8
	},
/obj/effect/turf_decal/industrial/warning,
/obj/effect/turf_decal/siding/wideplating{
	dir = 1
	},
/obj/structure/window/reinforced{
	dir = 4
	},
/obj/item/gun/ballistic/automatic/smg/pounder,
/obj/item/gun/ballistic/automatic/pistol/mauler,
/obj/item/gun/ballistic/automatic/pistol/mauler,
/obj/item/gun/ballistic/automatic/pistol/spitter,
/obj/item/gun/ballistic/automatic/assault/skm/pirate,
/obj/machinery/light/directional/north,
/obj/structure/closet/secure_closet{
	icon_state = "sec";
	name = "equipment locker";
	req_access_txt = "1"
	},
/turf/open/floor/plasteel/patterned/cargo_one,
/area/ship/engineering/engine)
"QT" = (
/obj/machinery/atmospherics/components/unary/tank/air{
	dir = 4
	},
/obj/effect/decal/cleanable/dirt,
/turf/open/floor/engine,
/area/ship/engineering/engine)
"QZ" = (
/obj/effect/decal/cleanable/dirt,
/turf/closed/wall/r_wall/syndicate/nodiagonal,
/area/ship/engineering/engine)
"SX" = (
/obj/effect/decal/cleanable/dirt,
/obj/structure/closet/secure_closet/wall/directional/east,
/obj/structure/table,
/obj/item/storage/firstaid/fire{
	pixel_x = -8;
	pixel_y = 6
	},
/obj/item/storage/firstaid/brute{
	pixel_y = 8;
	pixel_x = 2
	},
/obj/item/clothing/gloves/color/latex{
	pixel_y = -13
	},
/obj/item/storage/belt/medical/webbing{
	pixel_y = 8;
	pixel_x = 5
	},
/obj/item/clothing/head/soft/mime,
/obj/item/clothing/accessory/armband/medblue{
	pixel_y = -1;
	pixel_x = -6
	},
/obj/item/storage/backpack/duffelbag/med/surgery{
	pixel_x = 4;
	pixel_y = 5
	},
/obj/item/clothing/suit/apron/surgical{
	pixel_x = -7;
	pixel_y = 10
	},
/obj/effect/turf_decal/corner/opaque/blue/full,
/obj/machinery/light/directional/north,
/turf/open/floor/plasteel/white,
/area/ship/engineering/engine)
"TD" = (
/obj/machinery/atmospherics/pipe/manifold/scrubbers/hidden/layer4{
	dir = 8
	},
/obj/effect/turf_decal/siding/wideplating{
	dir = 10
	},
/obj/machinery/light/directional/west,
/turf/open/floor/plasteel/patterned/cargo_one,
/area/ship/engineering/engine)
"Ui" = (
/obj/machinery/door/poddoor{
	id = "premier_bridge";
	dir = 4
	},
/obj/machinery/power/shieldwallgen/atmos/roundstart{
	id = "tortuga_holo";
	dir = 1
	},
/turf/open/floor/plating,
/area/ship/engineering/engine)
"Us" = (
/obj/machinery/power/terminal,
/obj/structure/cable/yellow{
	icon_state = "0-1"
	},
/obj/machinery/suit_storage_unit/industrial{
	suit_type = /obj/item/clothing/suit/space/hardsuit/security/independent/frontier
	},
/obj/structure/window/reinforced{
	dir = 4
	},
/obj/effect/turf_decal/siding/wideplating,
/turf/open/floor/plasteel/patterned/cargo_one,
/area/ship/engineering/engine)
"UG" = (
/obj/structure/window/reinforced{
	dir = 8
	},
/obj/structure/closet/secure_closet{
	icon_state = "sec";
	name = "equipment locker";
	req_access_txt = "1"
	},
/obj/effect/turf_decal/industrial/warning{
	dir = 1
	},
/obj/effect/turf_decal/siding/wideplating,
/obj/item/ammo_box/magazine/skm_762_40{
	pixel_y = -3
	},
/obj/item/ammo_box/magazine/skm_762_40{
	pixel_x = 5
	},
/obj/item/ammo_box/magazine/skm_762_40{
	pixel_x = 5
	},
/obj/item/storage/toolbox/ammo/a762_40{
	pixel_x = 5;
	pixel_y = 6
	},
/obj/item/ammo_box/magazine/spitter_9mm,
/obj/item/ammo_box/magazine/spitter_9mm,
/obj/item/ammo_box/magazine/spitter_9mm,
/obj/item/ammo_box/c9mm,
/obj/item/ammo_box/c9mm,
/obj/item/ammo_box/magazine/m9mm_mauler,
/obj/item/ammo_box/magazine/m9mm_mauler,
/obj/item/ammo_box/magazine/m9mm_mauler,
/obj/item/ammo_box/magazine/m9mm_mauler,
/obj/item/ammo_box/magazine/m9mm_mauler,
/obj/item/ammo_box/magazine/m9mm_mauler,
/obj/item/ammo_box/c9mm,
/obj/item/ammo_box/c9mm,
/obj/item/ammo_box/magazine/c22lr_pounder_pan,
/obj/item/ammo_box/magazine/c22lr_pounder_pan,
/obj/item/ammo_box/magazine/c22lr_pounder_pan,
/obj/item/ammo_box/c22lr_box,
/obj/item/ammo_box/c22lr_box,
/obj/machinery/light/directional/south,
/obj/item/storage/belt/utility/full/engi{
	pixel_y = -9
	},
/turf/open/floor/plasteel/patterned/cargo_one,
/area/ship/engineering/engine)
"Vp" = (
/obj/structure/sign/poster/retro/random,
/turf/closed/wall/r_wall/syndicate/nodiagonal,
/area/ship/engineering/engine)
"VT" = (
/obj/structure/railing{
	dir = 1;
	layer = 2.89
	},
/turf/template_noop,
/area/space)
"Wd" = (
/obj/machinery/atmospherics/pipe/simple/scrubbers/hidden/layer4{
	dir = 1
	},
/obj/machinery/atmospherics/pipe/simple/scrubbers/hidden/layer4{
	dir = 1
	},
/turf/closed/wall/r_wall/syndicate/nodiagonal,
/area/ship/engineering/engine)
"Wv" = (
/obj/structure/railing{
	layer = 3.1
	},
/turf/template_noop,
/area/space)
"WK" = (
/obj/effect/decal/cleanable/dirt,
/obj/machinery/atmospherics/pipe/simple/scrubbers/hidden/layer4{
	dir = 1
	},
/obj/machinery/door/airlock/command{
	req_one_access = list(19)
	},
/obj/effect/turf_decal/techfloor{
	dir = 1
	},
/obj/structure/curtain/cloth/grey,
/turf/open/floor/plasteel/telecomms_floor,
/area/ship/engineering/engine)
"Yd" = (
/obj/effect/decal/cleanable/dirt,
/obj/effect/turf_decal/siding/wideplating{
	dir = 8
	},
/obj/machinery/light/directional/west,
/obj/machinery/atmospherics/pipe/simple/supply/hidden/layer2,
/turf/open/floor/plasteel/patterned/cargo_one,
/area/ship/engineering/engine)
"Yt" = (
/obj/machinery/power/smes/shuttle/precharged{
	dir = 1
	},
/obj/structure/window/reinforced{
	dir = 1
	},
/turf/open/floor/engine,
/area/ship/engineering/engine)
"YI" = (
/obj/structure/cable/yellow{
	icon_state = "1-10"
	},
/obj/structure/cable/yellow{
	icon_state = "2-10"
	},
/obj/structure/cable/yellow{
	icon_state = "2-4"
	},
/obj/structure/cable/yellow{
	icon_state = "6-10"
	},
/obj/machinery/atmospherics/components/unary/vent_pump/on/layer2{
	dir = 4
	},
/turf/open/floor/plasteel/patterned/cargo_one,
/area/ship/engineering/engine)
"YM" = (
/obj/structure/railing,
/turf/template_noop,
/area/space)
"Zs" = (
/obj/machinery/atmospherics/pipe/simple/supply/hidden/layer2{
	dir = 8
	},
/turf/open/floor/plasteel/patterned/cargo_one,
/area/ship/engineering/engine)
"ZB" = (
/obj/effect/decal/cleanable/dirt,
/obj/machinery/atmospherics/pipe/simple/supply/hidden/layer2{
	dir = 8
	},
/turf/open/floor/plasteel/patterned/cargo_one,
/area/ship/engineering/engine)
"ZJ" = (
/obj/structure/cable{
	icon_state = "2-4"
	},
/obj/machinery/computer/helm/viewscreen/directional/north,
/obj/effect/turf_decal/siding/wideplating{
	dir = 1
	},
/obj/effect/decal/cleanable/vomit{
	pixel_x = 8;
	pixel_y = 14
	},
/obj/structure/fluff/bus{
	dir = 4;
	can_buckle = 1
	},
/obj/effect/decal/cleanable/plasma{
	pixel_x = 18;
	pixel_y = -5
	},
/turf/open/floor/plasteel/patterned/cargo_one,
/area/ship/engineering/engine)

(1,1,1) = {"
Es
cF
cF
cF
kR
kR
Jh
kR
cF
cF
cF
BX
"}
(2,1,1) = {"
Wv
Hm
cF
cF
ax
dx
dx
Ui
cF
cF
Hm
sV
"}
(3,1,1) = {"
Wv
Hm
Hm
LT
Nr
Jl
Bd
fV
cF
Hm
Hm
sV
"}
(4,1,1) = {"
cF
Hm
Hm
cF
ZJ
Ou
ss
Jv
cF
Hm
Hm
cF
"}
(5,1,1) = {"
cF
CH
CH
cF
vC
Nn
gV
xq
tx
CH
CH
cF
"}
(6,1,1) = {"
cF
uG
OG
II
GS
YI
pc
Nm
Yt
Hf
pD
cF
"}
(7,1,1) = {"
cF
Vp
aR
II
zO
hG
in
Us
Yt
ay
cF
cF
"}
(8,1,1) = {"
VT
cF
cF
LT
PE
Zs
Eg
UG
cF
cF
cF
YM
"}
(9,1,1) = {"
VT
Hm
cF
cF
sM
ZB
Eg
gR
cF
cF
Hm
YM
"}
(10,1,1) = {"
cF
Hm
Hm
Lr
NV
fd
Pb
lY
Lr
Hm
Hm
cF
"}
(11,1,1) = {"
cF
cF
cF
cF
cF
Mf
ic
QZ
cF
cF
cF
cF
"}
(12,1,1) = {"
cF
QT
Oy
KZ
Yd
wn
gb
TD
WK
Ef
cF
cF
"}
(13,1,1) = {"
cF
cF
kL
hE
Lz
uP
Hx
Pf
cF
hK
Wd
sO
"}
(14,1,1) = {"
Hm
cF
LT
SX
rB
Ey
ko
FI
QZ
cF
cF
Hm
"}
(15,1,1) = {"
Hm
Hm
cF
cF
Lr
NH
NH
NH
LT
cF
Hm
Hm
"}
