//MAP CONVERTED BY dmm2tgm.py THIS HEADER COMMENT PREVENTS RECONVERSION, DO NOT REMOVE
"aT" = (
/obj/structure/window/reinforced{
	dir = 8
	},
/obj/effect/turf_decal/corner/opaque/blue/diagonal,
/obj/effect/turf_decal/siding/blue{
	dir = 8
	},
/obj/structure/closet/crate/freezer/blood,
/obj/structure/sink/greyscale{
	pixel_y = 18
	},
/turf/open/floor/plasteel/white,
/area/ship/engineering/engine)
"bp" = (
/obj/effect/turf_decal/siding/wideplating{
	dir = 1
	},
/obj/machinery/light/directional/north,
/turf/open/floor/plasteel/patterned/cargo_one,
/area/ship/engineering/engine)
"bs" = (
/obj/structure/railing{
	layer = 3.1
	},
/turf/template_noop,
/area/space)
"cW" = (
/turf/open/floor/engine/hull,
/area/ship/engineering/engine)
"dM" = (
/obj/effect/turf_decal/siding/wideplating{
	dir = 8
	},
/obj/machinery/light/directional/west,
/obj/machinery/atmospherics/pipe/simple/supply/hidden/layer2,
/turf/open/floor/plasteel/patterned/cargo_one,
/area/ship/engineering/engine)
"dZ" = (
/obj/structure/cable{
	icon_state = "2-4"
	},
/obj/machinery/computer/helm/viewscreen/directional/north,
/obj/effect/turf_decal/siding/wideplating{
	dir = 1
	},
/turf/open/floor/plasteel/patterned/cargo_one,
/area/ship/engineering/engine)
"ee" = (
/obj/effect/decal/cleanable/dirt,
/turf/closed/wall/r_wall/syndicate/nodiagonal,
/area/ship/engineering/engine)
"eh" = (
/obj/structure/railing,
/turf/template_noop,
/area/space)
"ei" = (
/obj/machinery/atmospherics/pipe/simple/scrubbers/hidden/layer4{
	dir = 1
	},
/obj/machinery/atmospherics/pipe/simple/scrubbers/hidden/layer4{
	dir = 1
	},
/turf/closed/wall/r_wall/syndicate/nodiagonal,
/area/ship/engineering/engine)
"eJ" = (
/obj/structure/cable{
	icon_state = "1-2"
	},
/turf/open/floor/plasteel/patterned/cargo_one,
/area/ship/engineering/engine)
"eO" = (
/obj/structure/closet/secure_closet/wall/directional/east,
/obj/structure/table,
/obj/effect/turf_decal/corner/opaque/blue/full,
/obj/machinery/light/directional/north,
/turf/open/floor/plasteel/white,
/area/ship/engineering/engine)
"fo" = (
/obj/machinery/power/smes/shuttle/precharged{
	dir = 2
	},
/obj/structure/window/reinforced,
/turf/open/floor/engine,
/area/ship/engineering/engine)
"ga" = (
/obj/machinery/atmospherics/pipe/layer_manifold{
	dir = 1
	},
/obj/machinery/door/window/southleft,
/turf/open/floor/engine,
/area/ship/engineering/engine)
"hw" = (
/obj/effect/turf_decal/siding/wideplating,
/turf/open/floor/plasteel/patterned/cargo_one,
/area/ship/engineering/engine)
"if" = (
/obj/structure/cable{
	icon_state = "1-8"
	},
/obj/structure/grille,
/obj/structure/window/reinforced{
	dir = 8
	},
/turf/open/floor/engine,
/area/ship/engineering/engine)
"jr" = (
/obj/machinery/door/airlock/command{
	dir = 4
	},
/turf/open/floor/plasteel/patterned/cargo_one,
/area/ship/engineering/engine)
"lU" = (
/obj/structure/cable/yellow{
	icon_state = "5-10"
	},
/obj/structure/cable/yellow{
	icon_state = "4-10"
	},
/obj/structure/cable{
	icon_state = "1-2"
	},
/turf/open/floor/plasteel/patterned/cargo_one,
/area/ship/engineering/engine)
"nr" = (
/obj/machinery/atmospherics/pipe/simple/supply/hidden/layer2{
	dir = 8
	},
/obj/effect/turf_decal/siding/wideplating{
	dir = 4
	},
/obj/effect/turf_decal/industrial/warning{
	dir = 4
	},
/turf/open/floor/plasteel/patterned/cargo_one,
/area/ship/engineering/engine)
"oE" = (
/obj/machinery/atmospherics/components/unary/outlet_injector/on/layer4{
	dir = 1
	},
/turf/open/floor/engine/hull,
/area/ship/engineering/engine)
"pc" = (
/obj/machinery/atmospherics/pipe/manifold/supply/hidden/layer2,
/obj/effect/turf_decal/siding/wideplating{
	dir = 8
	},
/turf/open/floor/plasteel/patterned/cargo_one,
/area/ship/engineering/engine)
"pB" = (
/obj/effect/decal/cleanable/dirt,
/obj/machinery/atmospherics/pipe/simple/scrubbers/hidden/layer4{
	dir = 10
	},
/obj/machinery/cryopod{
	dir = 8
	},
/obj/structure/railing{
	dir = 2;
	layer = 4.1
	},
/obj/machinery/computer/cryopod/directional/east,
/obj/machinery/light/directional/north,
/obj/effect/decal/cleanable/plasma{
	pixel_x = 18;
	pixel_y = -5
	},
/turf/open/floor/plasteel/telecomms_floor,
/area/ship/engineering/engine)
"rQ" = (
/obj/machinery/computer/helm{
	dir = 8;
	icon_state = "computer-right"
	},
/obj/structure/window/reinforced,
/obj/effect/turf_decal/siding/wideplating{
	dir = 4
	},
/turf/open/floor/plasteel/patterned/cargo_one,
/area/ship/engineering/engine)
"rZ" = (
/obj/effect/turf_decal/siding/wideplating{
	dir = 9
	},
/obj/machinery/button/door{
	id = "watchdog_cargo";
	pixel_y = 25;
	pixel_x = -3
	},
/obj/machinery/button/shieldwallgen{
	id = "tortuga_holo";
	pixel_x = 8;
	pixel_y = 23
	},
/obj/effect/turf_decal/industrial/warning{
	dir = 8
	},
/turf/open/floor/plasteel/patterned/cargo_one,
/area/ship/engineering/engine)
"sa" = (
/obj/machinery/power/terminal{
	dir = 1
	},
/obj/structure/cable/yellow{
	icon_state = "0-2"
	},
/obj/effect/turf_decal/siding/wideplating{
	dir = 1
	},
/turf/open/floor/plasteel/patterned/cargo_one,
/area/ship/engineering/engine)
"sE" = (
/obj/structure/cable/yellow{
	icon_state = "1-8"
	},
/obj/machinery/atmospherics/pipe/simple/supply/hidden/layer2{
	dir = 8
	},
/turf/open/floor/plasteel/patterned/cargo_one,
/area/ship/engineering/engine)
"sK" = (
/obj/effect/turf_decal/corner/opaque/blue/diagonal,
/obj/effect/turf_decal/siding/blue{
	dir = 10
	},
/obj/machinery/door/window/westright,
/obj/structure/window/reinforced,
/turf/open/floor/plasteel/white,
/area/ship/engineering/engine)
"uA" = (
/obj/structure/bed{
	dir = 1
	},
/obj/effect/turf_decal/corner/opaque/blue/full,
/obj/effect/turf_decal/siding/blue{
	dir = 7
	},
/obj/structure/window/reinforced,
/turf/open/floor/plasteel/white,
/area/ship/engineering/engine)
"vm" = (
/obj/structure/railing/corner,
/turf/template_noop,
/area/space)
"vP" = (
/obj/structure/railing/corner{
	dir = 4
	},
/turf/template_noop,
/area/space)
"wr" = (
/obj/structure/railing{
	dir = 1;
	layer = 2.89
	},
/turf/template_noop,
/area/space)
"zb" = (
/obj/machinery/atmospherics/components/unary/tank/air{
	dir = 4
	},
/turf/open/floor/engine,
/area/ship/engineering/engine)
"Ax" = (
/obj/machinery/atmospherics/pipe/manifold/scrubbers/hidden/layer4{
	dir = 8
	},
/obj/effect/turf_decal/siding/wideplating{
	dir = 10
	},
/obj/machinery/light/directional/west,
/turf/open/floor/plasteel/patterned/cargo_one,
/area/ship/engineering/engine)
"AZ" = (
/obj/effect/turf_decal/siding/wideplating{
	dir = 6
	},
/obj/effect/turf_decal/industrial/warning/corner{
	dir = 4
	},
/turf/open/floor/plasteel/patterned/cargo_one,
/area/ship/engineering/engine)
"Bf" = (
/obj/machinery/atmospherics/pipe/simple/scrubbers/hidden/layer4{
	dir = 4
	},
/obj/effect/turf_decal/siding/wideplating{
	dir = 4
	},
/obj/effect/turf_decal/industrial/warning{
	dir = 4
	},
/turf/open/floor/plasteel/patterned/cargo_one,
/area/ship/engineering/engine)
"BH" = (
/obj/effect/decal/cleanable/dirt,
/obj/machinery/atmospherics/pipe/simple/scrubbers/hidden/layer4{
	dir = 1
	},
/obj/machinery/door/airlock/command{
	req_one_access = list(19)
	},
/obj/effect/turf_decal/techfloor{
	dir = 1
	},
/obj/structure/curtain/cloth/grey,
/turf/open/floor/plasteel/telecomms_floor,
/area/ship/engineering/engine)
"Cb" = (
/obj/structure/cable/yellow{
	icon_state = "1-10"
	},
/obj/structure/cable/yellow{
	icon_state = "2-10"
	},
/obj/structure/cable/yellow{
	icon_state = "2-4"
	},
/obj/structure/cable/yellow{
	icon_state = "6-10"
	},
/obj/machinery/atmospherics/components/unary/vent_pump/on/layer2{
	dir = 4
	},
/turf/open/floor/plasteel/patterned/cargo_one,
/area/ship/engineering/engine)
"Dm" = (
/obj/structure/cable{
	icon_state = "2-8"
	},
/obj/structure/cable{
	icon_state = "1-2"
	},
/obj/structure/cable{
	icon_state = "1-4"
	},
/obj/structure/grille,
/obj/structure/window/reinforced{
	dir = 8
	},
/turf/open/floor/engine,
/area/ship/engineering/engine)
"Dt" = (
/obj/machinery/atmospherics/components/binary/pump,
/obj/structure/reagent_dispensers/fueltank,
/turf/open/floor/engine,
/area/ship/engineering/engine)
"DM" = (
/obj/machinery/atmospherics/components/unary/vent_pump/on/layer2{
	dir = 8
	},
/turf/open/floor/plasteel/patterned/cargo_one,
/area/ship/engineering/engine)
"Em" = (
/obj/machinery/atmospherics/pipe/simple/scrubbers/hidden/layer4{
	dir = 5
	},
/obj/structure/railing{
	dir = 10;
	layer = 3.1
	},
/obj/structure/closet/secure_closet/wall/directional/south,
/obj/item/clothing/shoes/jackboots{
	pixel_y = -13;
	pixel_x = -8
	},
/obj/item/clothing/shoes/jackboots{
	pixel_y = -13;
	pixel_x = -4
	},
/obj/item/clothing/shoes/jackboots{
	pixel_y = -13
	},
/obj/item/clothing/shoes/jackboots{
	pixel_y = -13;
	pixel_x = 4
	},
/obj/item/clothing/shoes/jackboots{
	pixel_y = -13;
	pixel_x = 8
	},
/turf/open/floor/plasteel/telecomms_floor,
/area/ship/engineering/engine)
"EQ" = (
/obj/structure/cable{
	icon_state = "1-8"
	},
/obj/structure/grille,
/turf/open/floor/engine,
/area/ship/engineering/engine)
"FL" = (
/obj/machinery/door/poddoor{
	id = "premier_bridge";
	dir = 4
	},
/obj/machinery/power/shieldwallgen/atmos/roundstart{
	id = "brawler_aft_holo"
	},
/turf/open/floor/plating,
/area/ship/engineering/engine)
"Gt" = (
/obj/machinery/power/terminal,
/obj/structure/cable/yellow{
	icon_state = "0-1"
	},
/obj/effect/turf_decal/siding/wideplating,
/turf/open/floor/plasteel/patterned/cargo_one,
/area/ship/engineering/engine)
"Gy" = (
/obj/machinery/power/smes/engineering,
/obj/structure/cable{
	icon_state = "0-8"
	},
/obj/effect/turf_decal/industrial/hatch/yellow,
/obj/effect/turf_decal/siding/wideplating{
	dir = 1
	},
/obj/machinery/light/directional/north,
/turf/open/floor/plasteel/patterned/cargo_one,
/area/ship/engineering/engine)
"Ha" = (
/turf/template_noop,
/area/space)
"He" = (
/obj/machinery/door/firedoor/window,
/obj/structure/window/reinforced/fulltile,
/obj/structure/grille,
/turf/open/floor/plating,
/area/ship/engineering/engine)
"Jn" = (
/obj/machinery/power/shuttle/engine/electric/premium{
	dir = 4
	},
/turf/open/space/basic,
/area/ship/engineering/engine)
"JT" = (
/obj/structure/cable/yellow{
	icon_state = "0-5"
	},
/obj/machinery/power/apc/auto_name/directional/south,
/obj/structure/cable{
	icon_state = "0-1"
	},
/obj/effect/turf_decal/siding/wideplating,
/obj/machinery/light_switch{
	dir = 1;
	pixel_x = 12;
	pixel_y = -16
	},
/turf/open/floor/plasteel/patterned/cargo_one,
/area/ship/engineering/engine)
"Kl" = (
/obj/effect/turf_decal/siding/wideplating{
	dir = 8
	},
/obj/effect/turf_decal/industrial/warning{
	dir = 8
	},
/turf/open/floor/plasteel/patterned/cargo_one,
/area/ship/engineering/engine)
"KV" = (
/obj/effect/turf_decal/siding/wideplating{
	dir = 5
	},
/obj/effect/turf_decal/industrial/warning/corner,
/turf/open/floor/plasteel/patterned/cargo_one,
/area/ship/engineering/engine)
"Lu" = (
/obj/structure/cable{
	icon_state = "0-1"
	},
/obj/effect/turf_decal/siding/wideplating,
/obj/machinery/light/directional/south,
/turf/open/floor/plasteel/patterned/cargo_one,
/area/ship/engineering/engine)
"LJ" = (
/obj/structure/window/reinforced{
	dir = 8
	},
/obj/effect/turf_decal/corner/opaque/blue/diagonal,
/obj/effect/turf_decal/siding/blue{
	dir = 8
	},
/obj/machinery/iv_drip,
/turf/open/floor/plasteel/white,
/area/ship/engineering/engine)
"Ma" = (
/turf/open/floor/plasteel/patterned/cargo_one,
/area/ship/engineering/engine)
"Mu" = (
/obj/effect/turf_decal/siding/wideplating,
/obj/structure/table,
/obj/machinery/button/door{
	dir = 8;
	id = "twinkle_rightmassdriver";
	pixel_x = 12;
	pixel_y = -5
	},
/obj/item/radio/intercom/wideband/table{
	dir = 4;
	pixel_x = 10;
	pixel_y = 8
	},
/turf/open/floor/plasteel/patterned/cargo_one,
/area/ship/engineering/engine)
"Ns" = (
/obj/structure/cable{
	icon_state = "2-8"
	},
/obj/structure/grille,
/turf/open/floor/engine,
/area/ship/engineering/engine)
"NK" = (
/obj/machinery/atmospherics/pipe/simple/scrubbers/hidden/layer4{
	dir = 4
	},
/turf/open/floor/plasteel/patterned/cargo_one,
/area/ship/engineering/engine)
"Ob" = (
/obj/machinery/atmospherics/pipe/simple/scrubbers/hidden/layer4{
	dir = 10
	},
/obj/effect/turf_decal/siding/wideplating{
	dir = 8
	},
/turf/open/floor/plasteel/patterned/cargo_one,
/area/ship/engineering/engine)
"On" = (
/obj/structure/cable{
	icon_state = "1-2"
	},
/obj/structure/cable{
	icon_state = "1-8"
	},
/obj/structure/cable{
	icon_state = "2-4"
	},
/obj/structure/grille,
/obj/structure/window/reinforced{
	dir = 8
	},
/turf/open/floor/engine,
/area/ship/engineering/engine)
"PK" = (
/obj/machinery/airalarm/directional/south,
/obj/effect/turf_decal/siding/wideplating{
	dir = 10
	},
/obj/effect/turf_decal/industrial/warning{
	dir = 8
	},
/turf/open/floor/plasteel/patterned/cargo_one,
/area/ship/engineering/engine)
"Qk" = (
/obj/machinery/computer/crew{
	dir = 8;
	icon_state = "computer-left"
	},
/obj/effect/turf_decal/siding/wideplating{
	dir = 4
	},
/turf/open/floor/plasteel/patterned/cargo_one,
/area/ship/engineering/engine)
"QA" = (
/obj/machinery/door/poddoor{
	id = "premier_bridge";
	dir = 4
	},
/turf/open/floor/plating,
/area/ship/engineering/engine)
"Su" = (
/obj/docking_port/mobile{
	dir = 4
	},
/turf/open/floor/engine/hull,
/area/ship/engineering/engine)
"SL" = (
/obj/machinery/atmospherics/components/unary/vent_scrubber/on/layer4{
	dir = 8
	},
/obj/effect/turf_decal/siding/wideplating,
/turf/open/floor/plasteel/patterned/cargo_one,
/area/ship/engineering/engine)
"Ty" = (
/obj/machinery/door/poddoor{
	id = "premier_bridge";
	dir = 4
	},
/obj/machinery/power/shieldwallgen/atmos/roundstart{
	id = "tortuga_holo";
	dir = 1
	},
/turf/open/floor/plating,
/area/ship/engineering/engine)
"Uh" = (
/obj/structure/cable{
	icon_state = "2-8"
	},
/obj/structure/grille,
/obj/structure/window/reinforced{
	dir = 8
	},
/turf/open/floor/engine,
/area/ship/engineering/engine)
"Um" = (
/obj/machinery/atmospherics/pipe/simple/supply/hidden/layer2{
	dir = 8
	},
/turf/open/floor/plasteel/patterned/cargo_one,
/area/ship/engineering/engine)
"Vb" = (
/obj/effect/decal/cleanable/dirt,
/obj/machinery/door/airlock/command{
	dir = 4
	},
/obj/machinery/atmospherics/pipe/simple/scrubbers/hidden/layer4{
	dir = 4
	},
/turf/open/floor/plasteel/patterned/cargo_one,
/area/ship/engineering/engine)
"Vt" = (
/obj/effect/turf_decal/siding/wideplating{
	dir = 1
	},
/turf/open/floor/plasteel/patterned/cargo_one,
/area/ship/engineering/engine)
"VJ" = (
/obj/machinery/power/smes/shuttle/precharged{
	dir = 1
	},
/obj/structure/window/reinforced{
	dir = 1
	},
/turf/open/floor/engine,
/area/ship/engineering/engine)
"Xm" = (
/obj/machinery/power/terminal{
	dir = 1
	},
/obj/structure/cable{
	icon_state = "0-2"
	},
/turf/open/floor/plasteel/patterned/cargo_one,
/area/ship/engineering/engine)
"XD" = (
/obj/structure/railing{
	dir = 1
	},
/turf/template_noop,
/area/space)
"XT" = (
/obj/structure/window/reinforced/fulltile,
/obj/structure/grille,
/obj/machinery/door/firedoor/window,
/turf/open/floor/plating,
/area/ship/engineering/engine)
"XW" = (
/obj/structure/cable/yellow{
	icon_state = "1-2"
	},
/obj/structure/cable/yellow{
	icon_state = "2-8"
	},
/obj/machinery/atmospherics/components/unary/vent_scrubber/on/layer4{
	dir = 4
	},
/turf/open/floor/plasteel/patterned/cargo_one,
/area/ship/engineering/engine)
"YK" = (
/obj/effect/turf_decal/siding/wideplating,
/obj/machinery/light/directional/south,
/turf/open/floor/plasteel/patterned/cargo_one,
/area/ship/engineering/engine)
"YX" = (
/turf/closed/wall/r_wall/syndicate/nodiagonal,
/area/ship/engineering/engine)
"ZQ" = (
/obj/structure/cable/yellow{
	icon_state = "2-9"
	},
/obj/machinery/atmospherics/pipe/simple/scrubbers/hidden/layer4{
	dir = 4
	},
/turf/open/floor/plasteel/patterned/cargo_one,
/area/ship/engineering/engine)

(1,1,1) = {"
vm
YX
YX
YX
cW
cW
Su
cW
YX
YX
YX
vP
"}
(2,1,1) = {"
bs
Ha
YX
YX
FL
QA
QA
Ty
YX
YX
Ha
XD
"}
(3,1,1) = {"
bs
Ha
Ha
YX
rZ
Kl
Kl
PK
YX
Ha
Ha
XD
"}
(4,1,1) = {"
YX
Ha
Ha
YX
dZ
eJ
eJ
JT
YX
Ha
Ha
YX
"}
(5,1,1) = {"
YX
Jn
Jn
YX
Gy
Xm
lU
Lu
YX
Jn
Jn
YX
"}
(6,1,1) = {"
YX
Uh
Dm
fo
sa
Cb
XW
Gt
VJ
On
if
YX
"}
(7,1,1) = {"
YX
YX
Ns
fo
sa
sE
ZQ
Gt
VJ
EQ
YX
YX
"}
(8,1,1) = {"
wr
YX
YX
YX
bp
Um
NK
YK
YX
YX
YX
eh
"}
(9,1,1) = {"
wr
Ha
YX
YX
Vt
Um
NK
hw
YX
YX
Ha
eh
"}
(10,1,1) = {"
YX
Ha
Ha
He
KV
nr
Bf
AZ
He
Ha
Ha
YX
"}
(11,1,1) = {"
YX
YX
YX
YX
YX
jr
Vb
ee
YX
YX
YX
YX
"}
(12,1,1) = {"
YX
zb
Dt
ga
dM
pc
Ob
Ax
BH
Em
YX
YX
"}
(13,1,1) = {"
YX
YX
aT
LJ
sK
DM
Ma
SL
YX
pB
ei
oE
"}
(14,1,1) = {"
Ha
YX
YX
eO
uA
Qk
rQ
Mu
ee
YX
YX
Ha
"}
(15,1,1) = {"
Ha
Ha
YX
YX
He
XT
XT
XT
YX
YX
Ha
Ha
"}
